10 10
1 1
10 10
1 1 1 1 1 1 4 7 8 X
1 1 1 6 1 1 1 5 8 8
4 1 1 1 1 1 1 4 6 7
1 1 5 1 1 X 1 1 3 6
1 1 1 1 1 X 1 9 1 1
1 1 3 1 1 1 1 1 9 1
6 1 1 1 1 X 1 1 1 2
7 7 1 X X X 1 1 1 1
8 8 1 1 1 1 1 1 1 1
X 8 7 1 7 1 1 8 1 1